11111111
10001001
10001001
10001001
10B00A01
10S00001
10000001
11111111
